88,88,88,88,88,88,88,88,88,88,88,88,88,88,88,88,88,88,88,88,88,88,88,10
88,42,42,42,42,42,42,42,42,42,42,88,42,42,42,42,42,42,42,42,42,42,88,10
88,64,88,88,88,42,88,88,88,88,42,88,42,88,88,88,88,42,88,88,88,64,88,10
88,42,88,88,88,42,88,88,88,88,42,88,42,88,88,88,88,42,88,88,88,42,88,10
88,42,42,42,42,42,42,42,42,42,42,42,42,42,42,42,42,42,42,42,42,42,88,10
88,42,88,88,88,42,88,42,88,88,88,88,88,88,88,42,88,42,88,88,88,42,88,10
88,42,42,42,42,42,88,42,42,42,42,88,42,42,42,42,88,42,42,42,42,42,88,10
88,88,88,88,88,42,88,88,88,88,32,88,32,88,88,88,88,42,88,88,88,88,88,10
88,88,88,88,88,42,88,32,32,32,32,32,32,32,32,32,88,42,88,88,88,88,88,10
88,88,88,88,88,42,88,32,88,88,88,32,88,88,88,32,88,42,88,88,88,88,88,10
32,32,32,32,32,42,88,32,88,77,77,32,77,77,88,32,88,42,32,32,32,32,32,10
88,88,88,88,88,42,88,32,88,88,88,32,88,88,88,32,88,42,88,88,88,88,88,10
88,88,88,88,88,42,88,32,32,32,32,32,32,32,32,32,88,42,88,88,88,88,88,10
88,88,88,88,88,42,88,32,88,88,88,88,88,88,88,32,88,42,88,88,88,88,88,10
88,88,88,88,88,42,88,32,88,88,88,88,88,88,88,32,88,42,88,88,88,88,88,10
88,42,42,42,42,42,42,42,42,42,42,88,42,42,42,42,42,42,42,42,42,42,88,10
88,42,88,88,88,42,88,88,88,88,42,88,42,88,88,88,88,42,88,88,88,42,88,10
88,64,42,42,88,42,42,42,42,42,42,67,42,42,42,42,42,42,88,42,42,64,88,10
88,88,88,42,88,42,88,42,88,88,88,88,88,88,88,42,88,42,88,42,88,88,88,10
88,42,42,42,42,42,88,42,42,42,42,88,42,42,42,42,88,42,42,42,42,42,88,10
88,42,88,88,88,88,88,88,88,88,42,88,42,88,88,88,88,88,88,88,88,42,88,10
88,42,88,88,88,88,88,88,88,88,42,88,42,88,88,88,88,88,88,88,88,42,88,10
88,42,42,42,42,42,42,42,42,42,42,42,42,42,42,42,42,42,42,42,42,42,88,10
88,88,88,88,88,88,88,88,88,88,88,88,88,88,88,88,88,88,88,88,88,88,88,10

#######################
#**********#**********#
#@###*####*#*####*###@#
#*###*####*#*####*###*#
#*********************#
#*###*#*#######*#*###*#
#*****#****#****#*****#
#####*#### # ####*#####
#####*#         #*#####
#####*# ### ### #*#####
     *# #MM MM# #*     
#####*# ### ### #*#####
#####*#         #*#####
#####*# ####### #*#####
#####*# ####### #*#####
#**********#**********#
#*###*####*#*####*###*#
#@**#******C******#**@#
###*#*#*#######*#*#*###
#*****#****#****#*****#
#*########*#*########*#
#*########*#*########*#
#*********************#
#######################